{
	"tileSize": 32,
	"nrRows": 13,
	"nrCols": 12,
	"levelLayout": [
		0,0,0,0,0,0,0,0,0,0,0,0,
		1,1,1,1,1,3,1,1,1,1,1,1,
		1,4,1,1,1,3,1,1,8,6,7,1,
		1,3,1,1,1,3,1,1,1,1,1,1,
		1,3,1,1,1,3,1,1,1,1,1,1,
		1,5,1,1,1,3,1,1,1,1,1,1,
		1,1,1,1,8,2,7,1,1,1,1,1,
		1,1,1,1,1,1,1,1,4,1,1,1,
		1,8,6,6,7,1,1,1,3,1,1,1,
		1,1,1,1,1,1,1,1,3,1,1,1,
		1,1,1,1,1,1,1,1,3,1,1,1,
		1,1,1,1,1,1,1,1,5,1,1,1,
		1,1,1,1,1,1,1,1,1,1,1,1	
	]
}


